Gd, Gd, Gd, Gd, Gd, Gd, Gd, Gd, Gd, Gd, Gd, Gs, Gd, Gd, Gd, Gd, Gd, Gd, Gd, Gd, Gd, Re, Re, Gd, Gd, Gd, Gd, Gll^Fp, Gd, Gd, Gd
Gd, Gd, Gd, Gd, Gd, Gs, Gd, Gs, Gs, Gd, Gd, Gd, Gd, Gd, Gd, Gd, Gd, Gd, Gd, Gd, Gd, Re, Re, Gd, Gd, Gd, Gd, Gll^Fp, Gd, Gll, Gs
Gd, Gd, Gd, Gd, Gd, Gs, Gs, Gd^Vl, Gd, Gs, Gd, Gs, Gs, Gll^Fp, Gs, Gll^Fp, Gd, Gs, Gd, Gd, Re, Re, Re, Gd, Gd, Gd, Gll, Gll^Fmf, Gll^Fp, Gll^Fp, Gll^Fp
Gd, Gd, Gd, Gd, Gs, Gs^Es, Gs, Gs, Gs, Gs^Em, Gs, Gs, Gll, Gll^Fp, Gll^Fp, Gll^Fp, Gll^Fp, Gll, Gd, Re, Re, Re, Gd, Gd^Vl, Gd, Gd, Gd, Gll^Fp, Gll^Fp, Gll^Fp, Gll^Fp
Gd, Gd, Gd, Gd, Gd, Gd, Gs, Gs, Gs, Gs, Gs, Gll, Gll^Fp, Gll, Gll^Fmf, Gll, Gll^Fp, Gll^Fp, Gd, Re, Re, Gd, Gd, Gs, Gs, Gs, Gs, Gll^Fp, Gll^Fmf, Gll^Fp, Gll^Fp
Gd, Gd, Gd, Gd, Gd, Gd, Gs, Gs, Gs, Gs, Gs, Gs, Gll^Fp, Gs, Gs, Gd, Gd, Re, Re, Re, Re, Gd, Gs, Gg, Gs, Gs, Gs^Em, Gll, Gll^Fp, Gll^Fp, Gs^Fp
Gd, Gd, Gd, Gd, Re, Gd, Gs, Gs, Gs, Gs, Gs, Gs^Vc, Gs, Gs, Gs, Gd, Re, Re, Re, Gd, Gd, Gs, Gg, Gg, Gg, Gs, Gg, Gs, Gs^Em, Gs, Gs
Rb, Gd, Gd, Gd, Gs^Es, Gs, Gs, Gs, Gs, Gs, Gs, Gs, Gs, Gs, Gs, Rd, Re, Rd, Rd, Gs^Vc, Gs, Gg, Gg, Gg, Gg, Gg, Gg, Gg, Gg, Gg^Em, Gg
Gd, Gs, Gs, Gs, Gs, Gs, Gs, Gs, Gs, Gs, Gs, Gs, Gs, Gs, Gs, Rd, 2 Rd, Rd, Gs, Gg, Gs, Gg, Gg, Gg, Gg, Gg, Gg, Ds, Gg, Gg, Gg
Gs^Es, Gs, Gs, Ds, Gs, Gs, Gs, Ds, Ds, Ds, Ds, Ds, Gs, Ds, Ds, Ds, Ds, Ds, Ds, Ds, Gg, Ds, Ds, Ds, Ds, Ds, Ds, Ds, Ds, Ds, Ds
Ds, Ds, Ds, Ds, Ds, Ds, Ds, Ww, Ww, Ww, Ww, Ww, Ds, Ds, Ds, Ds, Ds, Ds, Ds, Ds, Ds, Ww, Ww, Ww, Ww, Ww, Ww, Ww, Ww, Ww, Ww
Wwf, Ww, Ww, Ww, Wwf, Ww, Ww, Wo, Ww, Wo, Wo, Wo, Ww, Wwf, Ww, Wwf, Wwf, Ww, Ww, Ww, Ww, Wo, Ww, Wo, Ww, Wo, Wo, Wo, Wo, Wo, Wo
Wo, Wo, Ww, Wo, Wo, Wo, Wo, Wo, Wo, Wo, Wo, Wo, Ww, Wwf, Ww, Ww, Wwf, Wwf, Ww, Wo, Wo, Wo, Wo, Wo, Wo, Wo, Wo, Wo, Wo, Wo, Wo
Wo, Wo, Wo, Wo, Wo, Wo, Wo, Wo, Wo, Wo, Wo, Wo, Wo, Wwf, Wwf, Wwf, Wwf, Wwf, Ww, Wo, Wo, Wo, Wo, Wo, Wo, Wo, Wo, Ww, Wo, Wo, Wo
Wo, Wo, Wo, Wo, Wo, Wo, Wo, Wo, Wo, Wo, Wo, Wo, Wo, Ww, Wwf, Wwf, Wwf, Ww, Ww, Wo, Wo, Wo, Wo, Wo, Wo, Ww, Ww, Ds, Ww, Ww, Ww
Wo, Wo, Wo, Wo, Wo, Wo, Wo, Wo, Wo, Ww, Ww, Ww, Ww, Ww, Wwf, Wwf, Ww, Ww, Ww, Wo, Wo, Wo, Wo, Wo, Wo, Ww, Ds, Gd, Ds, Ds, Ds
Wo, Wo, Wo, Wo, Wo, Wo, Wo, Wo, Ww, Ds, Ds, Ds, Ww, Ww, Ww, Wwf, Wwf, Wwf, Wo, Wo, Wo, Wo, Wo, Wo, Wo, Ww, Gs^Vh, Gs, Gd^Fp, Gs^Fp, Gs^Fp
Wo, Wo, Wo, Wo, Wo, Wo, Wo, Wo, Ww, Ww, Gs^Vh, Ds, Ds, Ww, Ww, Wwf, Wwf, Ww, Wo, Wo, Wo, Wo, Wo, Wo, Wo, Wo, Ww, Ww, Ww, Ww, Ww
Wo, Wo, Wo, Wo, Wo, Wo, Wo, Wo, Ww, Ww, Ds, Ds, Ww, Ww, Ww, Wwf, Ww, Wwf, Ww, Wo, Wo, Wo, Wo, Wo, Wo, Wo, Wo, Wo, Wo, Wo, Wo
Wo, Wo, Wo, Wo, Wo, Wo, Wo, Wo, Wo, Wo, Ww, Ww, Ww, Ww, Wwf, Ww, Ww, Wwf, Wwf, Wo, Wo, Wo, Wo, Wo, Wo, Wo, Wo, Wo, Wo, Wo, Wo
Wo, Wo, Wo, Wo, Wo, Wo, Wo, Wo, Wo, Wo, Wo, Ww, Ww, Ww, Wwf, Wwf, Wwf, Wwf, Ww, Wwf, Wo, Ww, Wo, Wo, Wo, Wo, Wo, Wo, Wo, Wo, Wo
Wo, Wo, Wo, Ww, Wo, Ww, Wo, Wo, Wo, Wo, Wo, Ww, Ww, Ww, Ww, Wwf, Wwf, Ww, Ww, Wwf, Ww, Ww, Ww, Ww, Ww, Ww, Ww, Ww, Ww, Ww, Ww
Ww, Ww, Ww, Ww, Ww, Ww, Ww, Ww, Ww, Ww, Ww, Ds, Ww, Ds, Ds, Ds, Wwf, Ds, Ds, Ds, Ds, Ds, Ww, Ww, Ww, Ds, Ds, Ds, Ww, Ww, Ww
Ww, Ds, Ww, Ds, Ds, Ds, Ds, Ds, Ww, Ds, Ds, Gg, Ds, Gg^Es, Ds, Rd, Ds, Rd, Gg^Es, Gg, Gg, Ds, Ww, Ww, Ww, Ds, Gg, Gg, Ds, Ds, Ds
Ds, Gg, Ds, Gg, Gg, Re, Gg^Vh, Gg, Ds, Gg, Gg, Gg, Gg, Gg, Gg^Es, 3 Re, Rd, Re, Gs^Es, Gs, Gg^Vh, Gg, Ds, Ce, Ds, Gs, Gg, Gg, Gg, Gg, Gg
Gg, Gg, Gg, Re^Gvs, Re^Gvs, Re^Gvs, Gg, Gg, Gg, Gg, Gg, Gg, Gg, Gg, Gg, Gs, Re, Re, Re, Gs, Gg, Re, Re, Gs, Gs, Re, Gg, Gg, Gg, Gg, Gg
Re, Re, Re^Gvs, Re^Gvs, Re^Gvs, Gg, Gg, Gg, Gs, Gg, Gg, Gs, Gg, Gg, Gs^Vh, Gs, Re, Re, Re, 1 Gs, Gs, Re, Gs, Re, Gs, Gs, Gs, Gs^Vh, Gs, Gs, Gg
Re^Gvs, Gg, Re, Gg, Gg, Gs, Gg, Gs, Gg, Gg, Gs, Gg, Gs, Gs, Gs, Gg, Gs, Re, Re, Gs, Gs, Re, Gs, Re, Re, Gs, Gg, Gg, Gs, Gs, Gs
Gg, Re, Gg, Re, Re, Re, Gg, Gs, Gg, Gs, Gg, Gs, Gg, Gs, Gs, Gs, Gs, Re, Re, Gs, Gs, Gs, Re, Gs, Gs, Gs, Gs, Gs, Gs, Gg, Gs
Re, Gs, Re, Gs, Gs, Gs, Re, Re, Re, Re, Gs, Gs, Gs, Re, Gs, Re, Re, Re, Re, Re, Gs, Gs, Gs, Gs, Gs, Gg, Gs, Gs, Gg, Gg, Gs
Gs, Gs, Gs, Gll^Fmf, Gll^Fmf, Gll^Fmf, Gll^Fmf, Gll^Fmf, Gs, Gs, Re, Re, Re, Gs, Re, Gs, Gs, Gs, Re, Re, Gs, Gs, Gs, Gs, Gg, Gg, Gg, Gs, Gg, Gs, Gs
Gs, Gs, Gll, Gll^Fmf, Gll^Fmf, Gs, Gll^Fmf, Gll^Fmf, Gll, Gg, Gs, Gs, Gs, Gg, Gs, Gs, Gs, Gs, Re, Re, Gs, Gs, Gs, Gg, Gs, Gs, Gs, Gg, Gs, Gg, Gs
