border_size=1
usage=map

Gs^Fp, Gs^Fp, Gs^Fp, Gs^Fp, Gg, Gs^Fp, Gg, Gg, Gg, Gg, Rr, Rr, Gg, Gg, Gg, Rr, Gg, Gll^Fp, Gll^Fp, Gll^Fp, Gll^Fp, Ww
Gs^Fp, Gs^Fp, Gll^Fp, Gs^Fp, Gll^Fp, Gg, Gg, Gg, Gg, Gg, Gg, Gg, Gg, Gg, Gg, Gll^Fp, Gll^Fp, Gg, Rr, Gll^Fp, Gg, Gg
Gll^Fp, Gll^Fp, Gll^Fp, Gll^Fp, Gs^Fp, Gg, Gg, Gll^Fp, Gg, Gg, Gg, 1 Re, Gg, Gs^Fms, Gll^Fp, Gll^Fp, Gll^Fp, Gll^Fp, Gll^Fp, Rr, Rr, Gg
Gll^Fp, Gll^Fp, Gll^Fp, Hh^Fms, Gs^Fp, Gg, Gll^Fp, Gll^Fp, Gll^Fp, Gg, Gll^Fp, Re, Gg, Gg, Gll^Fp, Gll^Fp, Gg, Gll^Fp, Gll^Fp, Gll^Fp, Rr, Gg
Gll^Fp, Gll^Fp, Hh^Fms, Gs^Fp, Hh, Gll^Fp, Gs^Fms, Gll^Fp, Hh^Fms, Gll^Fp, Gll^Fp, Re, Gs^Fms, Gs^Fms, Gll^Fp, Gll^Fp, Gg, Gg, Gll^Fp, Gll^Fp, Gg, Rr
Gs^Fp, Gll^Fp, Hh^Fms, Hh, Gll^Fp, Gll^Fp, Hh, Hh^Fms, Gll^Fp, Hh^Fms, Gg, Re, Gll^Fp, Gs^Fms, Gll^Fp, Gll^Fp, Gs^Fms, Gll^Fp, Gll^Fp, Gg, Gll^Fp, Gg
Gs^Fp, Gs^Fp, Gg, Gg, Gll^Fp, Gll^Fp, Gs^Fms, Gs^Fms, Gg, Gg, Gs^Fp, Gs^Fp, Hh^Fms, Gll^Fp, Gll^Fp, Gll^Fp, Gll^Fp, Gs^Fms, Gll^Fp, Gg, Gll^Fp, Gll^Fp
Gs^Fp, Gs^Fp, Gg, Gll^Fp, Gs^Fms, Gll^Fp, Re, Re, Gg, Gll^Fp, Gll^Fp, Gll^Fp, Gll^Fp, Gg, Gll^Fp, Gg, Gg, Gll^Fp, Gll^Fp, Gll^Fp, Gll^Fp, Gg
Gs^Fp, Gs^Fp, Gs^Fp, Gs^Fp, Re, Re, Gg, Gll^Fp, Gg, Gs^Fp, Gs^Fp, Gll^Fp, Gg, Gg, Gg, Gg, Gg, Gll^Fp, Gll^Fp, Gs^Fms, Gll^Fp, Gll^Fp
Gs^Fp, Gs^Fp, Hh^Fp, Gs^Fp, Re, Gg, Gg, Gs^Fms, Gs^Fp, Gs^Fp, Gg, Gg, Gll^Fp, Gll^Fp, Gs^Fms, Gll^Fp, Gll^Fp, Gll^Fp, Gll^Fp, Gll^Fp, Gll^Fp, Gll^Fp
Rr, Gg, Hh^Fp, Gs^Fp, Re, Gg, Gs^Fms, Gg, Gs^Fp, Hh, Gll^Fp, Gll^Fp, Gg, Gg, Gll^Fp, Gll^Fp, Gs^Fms, Hh, Gs^Fms, Hh, Gll^Fp, Gll^Fp
Gs^Fp, Rr, Gll^Fp, Hh^Fp, Re, Gg, Gg, Gg, Gs^Fp, Hh^Fp, Hh^Fp, Gll^Fp, Gll^Fp, Gll^Fp, Gll^Fp, Gll^Fp, Gg, Gll^Fp, Gll^Fp, Gll^Fp, Gll^Fp, Gll^Fp
Gg, Rr, Gs^Fp, Gs^Fms, Re, Gg, Gg, Gs^Fms, Gs^Fms, Gll^Fp, Gs^Fp, Gll^Fp, Gll^Fp, Gs^Fms, Gll^Fp, Gll^Fp, Gg, Gll^Fp, Gg, Gll^Fp, Gll^Fp, Gll^Fp
Gll^Fp, Rr, Rr, Gs^Fms, Re, Gg, Gll^Fp, Gg, Gg, Gll^Fp, Gg, Gg, Gg, Gll^Fp, Gll^Fp, Gll^Fp, Gs^Fms, Gll^Fp, Gs^Fms, Gll^Fp, Gll^Fp, Gll^Fp
Gll^Fp, Gll^Fp, Gg, Rr, Rr, Gg, Gll^Fp, Gll^Fp, Gg, Gs^Fms, Gg, Gg, Gll^Fp, Gll^Fp, Gll^Fp, Gll^Fp, Gll^Fp, Gll^Fp, Gll^Fp, Gll^Fp, Gll^Fp, Gll^Fp
Gll^Fp, Gll^Fp, Gll^Fp, Gg, Rr, Gg, Gg, Gll^Fp, Rr, Gg, Rr, Gg, Gg, Gll^Fp, Gg, Gs^Fms, Gs^Fms, Gs^Fms, Gs^Fms, Gs^Fms, Gs^Fms, Gll^Fp
Gg, Gll^Fp, Gg, Gll^Fp, Gll^Fp, Rr, Rr, Rr, Gg, Gll^Fp, Gg, Rr, Rr, Hh^Fp, Hh^Fp, Gg, Gg, Gs^Fms, Gg, Gs^Fms, Gs^Fms, Gll^Fp
Gll^Fp, Gll^Fp, Gll^Fp, Gll^Fp, Gll^Fp, Gll^Fp, Gg, Gg, Gll^Fp, Gll^Fp, Gg, Gg, Rr, Hh^Fp, Gll^Fp, Gg, Gg, Gg, Gg, Gs^Fms, Gs^Fms, Gll^Fp
Gg, Gg, Gll^Fp, Gll^Fp, Gll^Fp, Gll^Fp, Gg, Gll^Fp, Hh^Fp, Gll^Fp, Gg, 2 Gg, Rr, Gll^Fp, Hh^Fp, Gll^Fp, Gll^Fp, Gll^Fp, Gll^Fp, Gll^Fp, Gll^Fp, Gll^Fp
Gg, Gll^Fp, Gll^Fp, Gll^Fp, Gll^Fp, Gll^Fp, Gll^Fp, Gll^Fp, Gll^Fp, Hh^Fp, Gg, Gg, Rr, Gll^Fp, Gll^Fp, Hh^Fp, Gll^Fp, Gll^Fp, Gll^Fp, Gll^Fp, Gll^Fp, Gll^Fp
Gs^Fp, Gg, Gg, Gs^Fp, Gll^Fp, Gll^Fp, Gll^Fp, Gll^Fp, Gll^Fp, Hh^Fp, Gg, Rr, Gg, Gll^Fp, Gll^Fp, Gll^Fp, Gll^Fp, Gll^Fp, Gll^Fp, Gll^Fp, Gll^Fp, Gll^Fp
Gs^Fp, Ss, Ss, Gg, Ww, Gll^Fp, Gll^Fp, Gll^Fp, Gg, Gll^Fp, Gll^Fp, Gg, Gg, Gll^Fp, Gll^Fp, Gll^Fp, Gll^Fp, Gll^Fp, Gg, Gll^Fp, Gll^Fp, Gll^Fp