border_size=1
usage=map

Gg          , Gg          , Gg          , Gg          , Gg          , Gg          , Gg          , Gg          , Gg          , Gg          , Gg          , Gg          , Gg          , Gg          , Gg          , Gg          , Gg          , Gg          , Gg          , Gg          , Gg          , Gg          , Gg          , Gg          , Gg          , Gg          , Gg          
Gg          , Gg          , Gg          , Gg          , Gg          , Gg          , Gg          , Gg          , Gg          , Gg          , Gg          , Gg          , Gg          , Gg          , Gg          , Gg          , Gg          , Gg          , Gg          , Gg          , Gg          , Gg          , Gg          , Gg          , Gg          , Gg          , Gg          
Gg          , Gg          , Gg          , Gg          , Gg          , Gg          , Gg          , Gg          , Gg          , Gg          , Gg          , Gg          , Gg          , Gg          , Gg          , Gg          , Gg          , Gg          , Gg          , Gg          , Gg          , Gg          , Gg          , Gg          , Gg          , Gg          , Gg          
Gg          , Gg          , Gg          , Gg          , Gg          , Gg          , Gg          , Gg          , Gg          , Gg          , Gg          , Gg          , Ww          , Gg          , Ww          , Gg          , Ww          , Gg          , Ww          , Gg          , Ww          , Gg          , Gg          , Gg          , Gg          , Gg          , Gg          
Gg          , Gg          , Gg          , Gg          , Ww          , Ww          , Ww          , Ww          , Ww          , Ww          , Ww          , Ww          , Ch          , Ww          , Ch          , Ww          , Ch          , Ww          , Ch          , Ww          , Ch          , Ww          , Ww          , Gg          , Gg          , Gg          , Gg          
Gg          , Gg          , Gg          , Ww          , Ch          , Ch          , Ch          , Ch          , Ch          , Ch          , Ch          , Ch          , Rb          , Ch          , Rb          , Ch          , Rb          , Ch          , Rb          , Ch          , Rb          , Ch          , Ch          , Ww          , Gg          , Gg          , Gg          
Gg          , Gg          , Gg          , Ww          , Ch          , Rb          , Rb          , Rb          , Rb          , Rb          , Rb          , Rb          , Rb          , Rb          , Rb          , Rb          , Rb          , Rb          , Rb          , Rb          , Rb          , Rb          , Ch          , Ww          , Gg          , Gg          , Gg          
Gg          , Gg          , Gg          , Ww          , Ch          , Rb          , Rb          , Rb          , Rb          , Rb          , Rb          , Rb          , Rb          , Rb          , Ch          , Ch          , Ch          , Ch          , Ch          , Rb          , Rb          , Rb          , Ch          , Ww          , Gg          , Gg          , Gg          
Gg          , Gg          , Gg          , Ww          , Ch          , Rb          , Rr^Vd       , Rb          , Rb          , Rb          , Rb          , Rb          , Rr          , Ch          , Rr          , Rr^Vhc      , Rr          , Rr^Vhc      , Ch          , Rb          , Rb          , Rb          , Ch          , Ww          , Ww          , Gg          , Gg          
Gg          , Gg          , Gg          , Ww          , Ch          , Rb          , Rr          , Rb          , Rb          , Rb          , Rr          , Rr          , Rr          , Ch          , Rr          , Rr^Vhc      , 2 Rr        , Rr          , Ch          , Rb          , Rb          , Rb          , Ch          , Ww          , Gg          , Gg          , Gg          
Gg          , Gg          , Gg          , Ww          , Ch          , Rb          , Rb          , Rr          , Rr          , Rr          , Rr          , Rr          , Rb          , Ch          , Ch          , Rr          , Rr^Vhc      , Rr          , Ch          , Rb          , Rb          , Rb          , Ch          , Ww          , Gg          , Gg          , Gg          
Gg          , Gg          , Gg          , Ww          , Ch          , Rb          , Rb          , Rb          , Rr          , Rr          , Rb          , Rb          , Rb          , Rb          , Rb          , Ch          , Ch          , Ch          , Rb          , Rb          , Rb          , Rb          , Ch          , Ww          , Gg          , Gg          , Gg          
Gg          , Gg          , Gg          , Ww          , Ch          , Rb          , Rb          , Rb          , Rr          , Rr          , Rb          , Rb          , Rb          , Rb          , Rb          , Rb          , Rb          , Rb          , Rb          , Rb          , Rb          , Rb          , Ch          , Ww          , Gg          , Gg          , Gg          
Gg          , Gg          , Gg          , Ww          , Rr          , Rb          , Rr          , Rb          , Rr          , Rr          , Rr          , Rb          , Rb          , Rb          , Rb          , Rb          , Rb          , Rb          , Rb          , Rb          , Rb          , Rb          , Rr          , Ww          , Gg          , Gg          , Gg          
Rr          , Gg          , 1 Rr        , Ww^Bsb/     , Rr          , Rr          , Rr          , Rr          , Rr          , Rr          , Rr          , Rr          , Rr          , Rr          , Rr          , Rr          , Rr          , Rr          , Rr          , Rr          , Rr          , Rr          , Rr          , Ww^Bsb\     , Rr          , Gg          , Gg          
Rr          , Rr          , Rr          , Ww^Bsb/     , Ch          , Rr          , Rr^Vhc      , Rr          , Rr          , Rr          , Rr^Vhc      , Rr          , Rr          , Rr          , Rr          , Rr          , Rr          , Rr          , Rr          , Rr          , Rr          , Rr          , Rr          , Ww^Bsb\     , Rr          , 3 Rr        , Rr          
Rr          , Rr          , Gg          , Ww          , Ch          , Rb          , Rb          , Rb          , Rr          , Rr          , Rb          , Rb          , Rr^Vhc      , Rb          , Rb          , Rb          , Rr^Vhc      , Rb          , Rb          , Rr^Vhc      , Rb          , Rb          , Ch          , Ww          , Gg          , Rr          , Rb          
Gg          , Gg          , Gg          , Ww          , Ch          , Rb          , Rb          , Rr^Vhc      , Rr          , Rr          , Rb          , Rb          , Rb          , Rb          , Rb          , Rb          , Rb          , Rb          , Rb          , Rb          , Rb          , Rb          , Gg          , Ww          , Ww          , Gg          , Gg          
Gg          , Gg          , Gg          , Ww          , Ch          , Rb          , Rr          , Rb          , Rr          , Rr          , Rb          , Rb          , Rb          , Rb          , Rb          , Rr^Vhc      , Rb          , Rb          , Rb          , Rb          , Rb          , Rb          , Gg          , Ww          , Ww          , Gg          , Gg          
Gg          , Gg          , Ww          , Ww          , Ch          , Rb          , Rr^Vhc      , Rr          , Rr          , Rr          , Rr          , Rr^Vhc      , Rr          , Rr          , Rr          , Rr          , Rr          , Rr^Vhc      , Rr          , Rr          , Rr          , Rb          , Ch          , Ww          , Gg          , Gg          , Gg          
Gg          , Gg          , Gg          , Ww          , Ch          , Rb          , Rb          , Rb          , Rr          , Rr          , Rb          , Rr          , Rb          , Rb          , Rr^Vhc      , Rb          , Rb          , Rr          , Rb          , Rr^Vhc      , Rb          , Rr          , Rr          , Ww          , Gg          , Gg          , Gg          
Gg          , Gg          , Gg          , Ww          , Ch          , Rb          , Rb          , Rb          , Rr          , Rr          , Rb          , Rr^Vhc      , Rb          , Rb          , Rb          , Rb          , Rb          , Rb          , Rb          , Rb          , Rb          , Rb          , Gg          , Ww^Bw\      , Rb          , Gg          , Gg          
Gg          , Gg          , Gg          , Ww          , Ch          , Rb          , Rb          , Rr^Vhc      , Rr          , Rr          , Rb          , Rb          , Rb          , Rb          , Rb          , Rb          , Rb          , Rb          , Rb          , Rb          , Rb          , Rb          , Rb          , Ww          , Gg          , Rb          , Rb          
Gg          , Gg          , Gg          , Ww          , Ch          , Rb          , Rb          , Rb          , Rr          , Rr          , Rb          , Rb          , Rb          , Rb          , Rb          , Rb          , Rb          , Rb          , Rb          , Rb          , Rb          , Rb          , Ch          , Ww          , Gg          , Gg          , Gg          
Gg          , Gg          , Gg          , Ww          , Ww          , Ch          , Ch          , Rb          , Rr          , Rr          , Ch          , Rb          , Ch          , Rb          , Ch          , Rb          , Ch          , Rb          , Ch          , Ch          , Ch          , Ch          , Ww          , Ww          , Gg          , Gg          , Gg          
Gg          , Gg          , Gg          , Ww          , Ww          , Ww          , Ww          , Ch          , Ww^Bsb|     , Rr          , Ww          , Ch          , Ww          , Ch          , Ww          , Ch          , Ww          , Ch          , Ww          , Ch          , Ww          , Ww          , Ww          , Gg          , Gg          , Gg          , Gg          
Gg          , Gg          , Gg          , Gg          , Gg          , Ww          , Gg          , Ww          , Rr          , Ww^Bsb|     , Gg          , Ww          , Gg          , Ww          , Gg          , Ww          , Gg          , Ww          , Gg          , Ww          , Gg          , Ww          , Gg          , Gg          , Gg          , Gg          , Gg          
Gg          , Gg          , Gg          , Gg          , Gg          , Gg          , Gg          , Gg          , Rr          , Rr          , Gg          , Gg          , Gg          , Gg          , Gg          , Gg          , Gg          , Gg          , Gg          , Gg          , Gg          , Gg          , Gg          , Gg          , Gg          , Gg          , Gg          
Gg          , Gg          , Gg          , Gg          , Gg          , Gg          , Gg          , Gg          , Rr          , Rr          , Gg          , Gg          , Gg          , Gg          , Gg          , Gg          , Gg          , Gg          , Gg          , Gg          , Gg          , Gg          , Gg          , Gg          , Gg          , Gg          , Gg          
