Xu, Xu, Xu, Xu, Xu, Xu, Xu, Xu, Xu, Xu, Xu, Xu, Xu, Xu, Xu, Xu, Xu, Xu, Xu, Xu, Xu, Xu, Xu, Xu, Uh^Ii, Xu, Xu, Xu, Xu, Gs^Fp, Gs^Fp, Gs^Fp
Xu, Xu, Xu, Xu, Xu, Xu, Xu, Xu, Xu, Xu, Xu, Xu, Xu, Xu, Xu, Xu, Xu, Xu, Xu, Xu, Xu, Xu, Xu, Xu, Uh^Ii, Xu, Xu, Xu, Xu, Gs^Fp, Gs^Fp, Gs^Fp
Xu, Xu, Uu^Uf, Re^Uf, Uu, Xu, Wo, Wo, Wo, Xu, Xu, Xu, Xu, Xu, Uh, Uu^Vu, Uu, Uu^Uf, Uh, Uh, Urb, Xu, Uu, Uh, Uu^Ii, Uh^Ii, Uu^Ufi, Uh^Ii, Re, Gg, Gg, Gg
Xu, Xu, Uu, Uu, Wo, Wo, Ww, Ww, Wo, Wo, Xu, Xu, Xu, Xu, Uh, Uu, Uu, Uu, Uu, Urb, 3 Urb, Urb, Uu, Uu^Uf, Uu^Uf, Uu^Ufi, Rr, Rr, Rr, Re, Re, Re
Xu, Xu, Wo, Ww^Bw\, Ww, Ww, Ww, Wo, Xu, Uu^Uf, Xu, Xu, Xu, Uh, Uh, Uu, Uu^Uf, Uu, Uu, Urb, Urb, Urb, Uu, Rr, Rr, Uu^Ufi, Rr, 1 Rr, Uu^Ii, Rr, Uh^Ii, Uh^Ii
Xu, Xu, Wo, Ww, Ww, Ww^Bw\, Ww^Bw\, Wo, Uu, Uu, Uu, Xu, Uu, Uu, Uu, Uu, Uu, Uu, Uu, Uu, Uu, Uu, Rr, Uu^Vud, Rr, Rr, Rr, Rr, Uh^Ii, Uh^Ii, Uu^Ii, Uu^Ii
Xu, Xu, Xu, Wo, Wo, Wo, Rd, Uu, Uh, Uh, Xu, Uu, Uh, Uu, Uu, Uu, Uu, Uu, Uu, Uu, Uu, Re^Uf, Rr, Rr, Rr, Rr, Uu^Uf, Uu^Vu, Uh^Ii, Xu, Xu, Xu
Xu, Xu, Xu, Uu^Uf, Uh, Re, Xu, Xu, Xu, Xu, Re^Uf, Uh, Rd, Re^Uf, Rr, Rr, Rr, Rr, Rr, Rr, Rr, Rr, Rr, Rr, Rr, Rr, Uu^Uf, Uh, Xu, Xu, Xu, Xu
Xu, Xu, Xu, Xu, Xu, Rd, Uu^Uf, Xu, Uu^Uf, Xu, Uu, Rd, Rr, Rr, Uu, Uu, Rd, Uu, Uu, Rr, Rr, Rr, Uu, Uu, Uu, Uu, Xu, Xu, Xu, Xu, Xu, Xu
Xu, Xu, Uh, Uh, Xu, Re, Rd, Rd, Uh, Uh, Rr, Rr, Rd, Uh, Re, Uu^Uf, Re, Rd, Uu, Rr, Rr, Rr, Uu, Uu, Uu, Uu, Uu, Xu, Uh, Uh, Xu, Xu
Xu, Xu, Uu^Uf, Uu, Uu, Uh, Rr, Rr, Rr, Rr, Re, Xu, Uh, Uu^Uf, Uu^Uf, Re, Uu^Uf, Uh, Uh, Rr, Rr, Uu^Uf, Uu, Uh, Uu, Uu, Uu, Uu, Uu, Uu, Xu, Xu
Xu, Xu, Rr, Uh, Rr, Rr, Uu, Uu, Rd, Re, Rd, Xu, Xu, Uh, Re, Xu, Xu, Xu, Xu, Rr, Rr, Rr, Uu^Uf, Uh, Xu, Xu, Xu, Uu, Uu, Uu, Xu, Xu
Rr, Rr, Uu^Uf, Rr, Rd, Uu, Xu, Xu, Xu, Xu, Xu, Uh, Uu^Uf, Re, Uh, Xu, Uh, Uh, Rd, Uu, Rr, Rr, Rd, Xu, Wo, Wo, Wo, Xu, Xu, Uu, Uu, Uu
Xu, Xu, Uh, Uu^Uf, Re^Uf, Re, Rd, Xu, Xu, Xu, Xu, Re, Uu^Uf, Rd, Xu, Xu, Uu^Uf, Uu^Uf, Re^Uf, Rr, Rr, Rr, Re^Uf, Xu, Wo, Xu, Ww, Xu, Uu, Xu, Uu, Uu
Xu, Xu, Uh, Re^Uf, Uu^Uf, Rd, Re, Xu, Uh, Xu, Uh, Uh, Xu, Uh, Rd, Uh, Rr, Uu, Rr, Rr, Rr, Re^Uf, Rd, Xu, Ww, Ww, Ww, Ww, Uu, Uu, Xu, Xu
Xu, Xu, Xu, Uh, Xu, Uu, Rd, Uh, Uu, Re, Xu, Uh, Xu, Uu, Re, Rr, Rr, Rr, Rr, Rr, Uu^Uf, Rd, Uu, Xu, Uu, Uu, Xu, Xu, Uu, Uu, Xu, Xu
Xu, Xu, Xu, Xu, Xu, Xu, Uu, Rd, Uu, Uh, Rd, Re, Uu, Re^Uf, Rr, Rr, Rr, Rr, Uu, Uh, Xu, Uu, Uu, Uu, Uu, Xu, Uu, Xu, Uu, Uu, Xu, Xu
Uh, Uh, Uh, Xu, Xu, Xu, Uu^Uf, Re, Xu, Xu, Rd, Uu, Cud, Uu, Rr, Rr, Re^Uf, Re^Uf, Uu, Uu, Uu^Uf, Xu, Xu, Uu, Uh, Uu, Uu, Uu, Uh, Uu, Xu, Xu
Uu^Uf, Uu^Uf, Uh, Xu, Ww, Ww, Uu, Re, Re, Uu, Uu, Uu, Rr, Rr, Rr, Rr, Rr, Uu, Uu, Uu, Xu, Uu, Uu, Uu, Uu, Uu, Uu^Uf, Uu, Uu^Vud, Uu, Xu, Xu
Rr, Rr, Rr, Uu, Uu, Uu, Rr, Rr, Rr, Uu^Vud, Rr, Rr, Rr, Rr, Rr, Rr, Cud, Uu, Uu, Xu, Xu, Xu, Xu, Xu, Xu, Uu^Uf, Uu^Uf, Uu^Uf, Uh, Xu, Xu, Xu
Uu^Uf, Uu^Uf, Uu^Uf, Rr, Rr, Rr, Cud, Cud, Cud, Rr, Rr, Rr, Rr, Rr, Rr, Uu, Uu, Uu, Xu, Xu, Xu, Xu, Xu, Xu, Xu, Xu, Xu, Xu, Xu, Xu, Xu, Xu
Uh, Uh, Uh, Rr, Rr, Cud, Rr, Cud, Rr, Rr, Rr, Cud, Rr, Uu^Vu, Uu, Rr, Rr, Uu, Rd, Xu, Xu, Xu, Uh, Xu, Uu^Uf, Xu, Uh, Xu, Xu, Xu, Xu, Xu
Xu, Xu, Xu, Uu, Rr, Cud, Rr, Rr, Rr, Cud, 2 Cud, Cud, Rr, Uu, Xu, Uu, Xu, Rd, Re, Rd, Uu, Uh, Rd, Re, Rd, Uh, Uu, Uh, Xu, Xu, Xu, Xu
Xu, Xu, Re, Re, Uh, Rr, Rr, Cud, Cud, Rr, Cud, Cud, Rr, Uu, Cud, Xu, Xu, Xu, Uu^Uf, Re, Rd, Re, Uu, Rd, Uu, Re, Re, Uh, Xu, Xu, Xu, Xu
Uu, Uu, Re, Xu, Xu, Xu, Xu, Rr, Rr, Rr, Rr, Rr, Rr, Uu, Uu, Xu, Uu, Xu, Uu, Rd, Uh, Rd, Xu, Xu, Uu, Rd, Rd, Rd, Xu, Xu, Xu, Xu
Qxu, Qxu, Uu, Uu, Uh, Xu, Xu, Uu, Uu^Uf, Uu, Uu^Vud, Uu, Rr, Uu, Uu, Uu, Ww, Ww, Ww, Ww, Wo, Xu, Xu, Xu, Uu, Uu, Re, Uu, Uu^Uf, Xu, Xu, Xu
Qxu, Qxu, Uu, Uu, Uh, Xu, Xu, Uu, Uu^Uf, Uu, Uu, Uu, Rr, Uu, Uu, Uu, Ww, Ww, Ww, Ww, Wo, Xu, Xu, Xu, Uu, Uu, Re, Uu, Uu^Uf, Xu, Xu, Xu
