border_size=1
usage=map

Gg, Gg, Gg, Gg, Gg, Gg, Gg, Gg, Gg, Gg, Rr, Gg, Gg, Gg, Gg, Gg, Ww, Gg, Gs^Fp, Ww, Gg, Gg
Gg, Gg, Gg, Gg, Gg, Gg, Gg, Hh, Gg, Gg, Rr, Gg, Gg, Gg, Hh, Gg, Ww, Gg, Ww, Ww, Gg, Gg
Gg, Gs^Fp, Gg, Gg, Gg, Gg, Gg, Hh, Gg, Gg, Rr, Gg, Gg, Hh, Rr, Gg, Ww, Gg, Ww, Gg, Aa, Ha
Gs^Fp, Gg, Gg, Gg, Gg, Gg, Gg, Hh, Hh, Gg, Rr, Gg, Gg, Gg, Gg, Rr, Rr, Gg, Gg, Ww, Hh, Ha
Gg, Gg, Gg, Gg, Gg, Gg, Gg, Hh, Hh, Rr, Gg, Gg, Gg, Gg, Gg, Gs^Fp, Gs^Fp, Rr, Rr, Ww, Hh, Mm
Rr, Gg, Gg, Gg, Gg, Gg, Gs^Fp, Gs^Fp, Rr, Rr, Gg, Gg, Gg, Gg, Gg, Gs^Fp, Ds, Gs^Fp, Gs^Fp, Ww^Bw\, Rr, Mm
Rr, Gs^Fp, Gs^Fp, Gg, Gg, Gg, Rr, Rrc, Gg, Gg, Ww, Gg, Ww, Gg, Ww, Gs^Fp, Ww, Ds, Gs^Fp, Ww, Rr, Mm
Rr, Gs^Fp, Gg, Gg, Gg, Gg, Rr, Gg, Ww, Ww, Gg, Ww, Gg, Ww, Gg, Ww, Ww, Ds, Gs^Fp, Ww, Gs^Fp, Rr
Rr, Gs^Fp, Gs^Fp, Gg, Ww, Ww, Ww^Bw|, Ww, Gg, Gg, Hh, Gg, Gg, Gg, Gg, Gs^Fp, Ce, Ww, Ww, Ww, Gg, Hh
Rr, Gg, Gg, Gg, Ww, Ce, Rr, Ce, Gg, Gg, Gg, Gg, Gs^Vh, Gg, Gg, Gs^Fp, Gs^Fp, Ce, Ds, Ww, Gg, Gg
Rr, Gs^Fp, Gg, Gg, Ww, Gg, Rr, Gg, Gg, Gg, Gg, Gg, Gg, Gs^Fds, Gg, Gg, Gg, Ce, Wo, Ww, Gg, Gg
Gs^Fp, Gs^Fp, Gg, Gg, Ww, Gg, Rr, Gg, Gg, Gs^Vl, 2 Gs^Fds, Gs^Vh, Gg, Gg, Gs^Vh, Gg, Gg, Ww, Ds, Ds, Gg, Gg
Gs^Fp, Gs^Fp, Gg, Gg, Ww, Gll^Fp, Rr, Gg, Gg, Gg, Gg, Gg, Gs^Vh, Gg, Gg, Gg, Gg, Ww, Gg, Gg, Gs^Fp, Gg
Gs^Fp, Gg, Gg, Gg, Ww, Ce, Rr, Gg, Gg, Gs^Vh, Gg, Gg, Gg, Gg, Gg, Gg, Ww, Ww, Gg, Gg, Gg, Gg
Gg, Gs^Fp, Gg, Gg, Gg, Ww, Ww^Bw|, Ce, Ww, Gg, Ww, Gg, Gll^Fp, Hh, Ww, Ww, Gg, Gg, Gg, Gg, Gg, Gg
Gs^Fp, Gg, Gg, Gg, Gg, Gg, Rr, Ww, Gg, Ww, Gg, Ww, Ww, Ww, Rb^Gvs, Gg^Eff, Gg^Eff, Gg, Gg, Gg, Gg, Gg
Gs^Fp, Gs^Fp, Gg, Gg, Gg, Gg, Rr, Gg, Gg, Gg, Gg^Eff, Gg^Eff, Rb^Gvs, Rb^Gvs, Gg, Gg^Vwm, Rb^Gvs, Gg^Eff, Gg^Eff, Gg, Gg, Gg
Gs^Fp, Gs^Fp, Gg, Gg, Gg, Gg, Rr, Gg, Gg, Gg^Eff, Gg^Eff, Rb^Gvs, Gg, Gg, Rb^Gvs, Rb^Gvs, Gg^Eff, Gg^Eff, Gs^Fp, Gs^Fp, Gs^Fp, Gs^Fp
Gs^Fp, Gs^Fp, Gg, Gg, Gg, Gg, Rr, Gg, Gg, Gg, Gg, Gg, Gg^Eff, Rb^Gvs, Gg^Eff, Gg^Eff, Gg, Gg, Gs^Fp, Gs^Fp, Gs^Fp, Gs^Fp
Gs^Fp, Gg, Gg, Gg, Gg, Gg, Gg, 1 Rr, Rr, Rr, Rr, Rr, Rr, Gg^Eff, Gg, Gg, Hh, Gg, Gs^Fp, Gs^Fp, Gs^Fp, Gs^Fp
Gs^Fp, Gg, Gg, Gg, Gg, Gg, Gg, Gg, Gg, Gg, Gg, Gg, Rr, Gg, Gg, Gg, Hh, Gs^Fp, Gg, Gs^Fp, Gs^Fp, Gs^Fp
Gg, Gg, Gg, Gg, Gg, Gg, Gg, Hh, Hh, Hh, Hh, Hh, Gg, Rr, Gg, Gg, Gg, Gg, Gs^Fp, Gs^Fp, Gg, Gg
