border_size=1
usage=map

Ww, Ww, Ww, Ww, Ai, Aa, Aa^Fpa, Rr, Aa, Aa, Ha, Aa, Ha, Mm, Mm, Mm, Mm, Mm, Mm, Mm, Mm^Xm, Mm^Xm, Mm, Mm, Mm, Mm, Mm, Mm, Mm, Mm, Mm, Mm, Mm, Mm, Mm, Mm, Mm, Mm, Mm, Ha, Ha, Ha, Ha, Ha, Ha, Ha, Ha, Aa, Aa, Aa, Re, Aa, Aa^Fpa, Aa^Fpa, Aa^Fpa, Aa^Fpa, Aa^Fpa
Ww, Ww, Wo, Ww, Ww, Ai, Ha, Rr, Aa^Fpa, Ha, Gs^Fp, Aa, Hh, Mm, Hh, Mm, Mm, Mm, Re^Gvs, Mm, Mm, Mm^Xm, Mm, Mm, Aa^Fpa, Aa^Fpa, Ha, Ha, Ha, Aa^Fpa, Aa, Ha, Mm, Ha, Ha^Vhha, Mm, Mm^Xm, Mm^Xm, Mm, Mm, Mm, Ha, Mm, Ha, Mm, Ha, Mm, Ha, Ha, Aa, Re, Ha, Aa, Aa^Fpa, Aa^Fpa, Aa^Fpa, Aa^Fpa
Ww, Ww, Wo, Wo, Ww, Ww, Ds, Rr, Rr, Gg, Gg^Vc, Re^Gvs, Re^Gvs, Hh, Gs^Fp, Gg^Vc, Hh, Re^Gvs, Ce, Ce, Ce, Mm^Xm, Mm, Mm^Vhh, Ha, Aa, Ai, Ai, Ai, Aa, Ai, Ai, Ai, Aa, Aa, Mm, Mm, Mm, Mm, Mm^Xm, Mm^Xm, Mm, Mm^Xm, Mm, Mm, Mm, Mm, Mm, Ha, Aa^Vha, Aa^Fpa, Re, Re, Aa^Fpa, Aa^Fpa, Aa^Fpa, Aa^Fpa
Ww, Ww, Wo, Wo, Ww, Wwf, Ds, Gg, Rr, Gg, Gg, Re^Gvs, Hh, Gg, Rr, Rr, Rr, Re^Gvs, Rr, Ce, Re^Gvs, Mm^Xm, Mm^Xm, Mm, Aa, Ai, Ai, Ai, Ww, Ai, Ww, Ww, Ww, Ai, Ha, Aa^Fpa, Ha, Mm, Mm, Mm, Mm, Mm^Xm, Mm^Xm, Mm^Xm, Mm^Xm, Mm^Xm, Mm, Mm, Mm, Ha, Ha, Aa^Fpa, Re, Aa, Aa^Fpa, Ha, Aa^Fpa
Wo, Ww, Ww, Ww, Ww, Ww, Ww, Hh, Hh, Rr, Ce, Hh, Re^Gvs, Rr, Hh, Hh, Gs^Fp, Rr, Gg^Vc, Re^Gvs, Mm, Mm, Mm^Xm, Aa^Fpa, Aa, Ai, Ai, Ww, Ww, Ww, Ha^Vhha, Ww, Wwf, Aa, Ha, Aa, Ha, Ha, Ha, Mm, Mm, Mm^Xm, Mm, Mm^Xm, Mm, Mm^Xm, Mm^Xm, Mm, Mm, Mm, Mm, Ha, Re, Aa^Vea, Ha, Aa^Fpa, Aa^Fpa
Wo, Wo, Wo, Ww, Ww, Ww, Ww, Ww, Gg^Vc, Rr, Ce, 3 Ce, Re^Gvs, Gg^Vc, Gg, Hh, Re^Gvs, Gg, Hh, Mm, Mm, Mm^Xm, Mm^Xm, Aa, Mm, Ai, Ai, Ai, Ww, Ww, Ha, Aa, Wwf, Aa, Wwf, Wwf, Ww, Aa^Fpa, Aa^Vha, Ha, Mm, Mm, Mm, Mm, Mm, Mm, Mm, Mm^Xm, Mm, Mm, Mm, Ha, Ha, Re, Aa, Aa^Fpa, Gs^Fp
Wo, Wo, Wo, Wo, Ww, Wwf, Wwf, Ds, Ds, Rr, Gg, Ce, Gs^Fp, Re^Gvs, Gg, Gg^Vc, Re^Gvs, Gg, Hh, Mm, Hh, Mm, Mm, Mm^Xm, Mm, Aa^Fpa, Ha, Ai, Ai, Ww, Wwf, Ww^Bw|, Ww, Ww, Aa, Ha, Mm, Ww, Ww, Hh, Hh, Mm, Hh, Mm, Mm, Mm, Hh, Mm, Mm, Mm^Xm, Mm, Ha, Hh, Re, Gg, Hh, Gs^Fp
Wo, Wo, Wo, Ww^Vm, Ww, Wwf, Ww, Ww, Hh, Rr, Rr, Gg, Hh, Hh, Gg, Re^Gvs, Gs^Fp, Gg, Gs^Fp, Gg, Hh, Mm, Mm, Mm^Xm, Mm, Mm, Ha, Mm, Xu, Xu, Cud, Uu^Ii, Uu^Ufi, Xu, Mm, Mm, Mm, Ai, Ww, Hh, Gs^Fp, Gs^Fp, Hh, Hh^Vhh, Hh, Hh, Mm, Mm, Mm, Mm^Xm, Mm, Mm, Hh, Re, Gs^Fp, Gs^Fp, Gs^Fp
Wo, Wo, Chw, Wo, Ww, Wwf, Wwf, Wwf, Ww, Gg, Rr, Gg, Gs^Fp, Gg, Gs^Fp, Gs^Fp, Gg^Ve, Gs^Fp, Cv, Gs^Fp, Gs^Fp, Gs^Fp, Gs^Fp, Hh, Hh, Mm, Mm, Mm, Xu, 4 Cud, Cud, Uu^Ii, Uu, Xu, Xu, Mm, Mm, Ha, Gg, Ww, Ww, Gg, Ww, Hh, Ww, Gg, Gs^Fp, Hh, Hh, Mm, Hh, Hh, Re, Re, Gs^Fp, Gs^Fp, Gs^Fp
Wo, Ww, 7 Khw, Chw, Wwf, Wwf, Wwf, Ww, Wwf, Ds, Rr, Gg, Gg, Gg, Gs^Fp, Gg^Fet, Gs^Fp, Gg^Fet, 8 Kv, Cv, Gs^Fp, Gs^Fp, Hh, Gs^Fp, Hh, Mm, Mm, Xu, Uh^Ii, Cud, Uh, Uh, Uu, Uu^Vud, Xu, Mm, Mm, Mm, Mm, Hh, Gs^Fp, Ww, Gs^Fp, Ww, Gg, Ww, Gg, Gs^Fp, Hh, Hh, Gs, Hh, Re, Gs^Fp, Gg^Ve, Gg^Fet, Gs^Fp
Wo, Chw, Chw, Ww, Ww^Vm, Ww, Ww, Wwf, Ww, Ds, Gg, Rr, Rr, Gg, Gs^Fp, Hh, Gs^Fp, Cv, Cv, Gg^Fet, Gs^Fp, Gg^Fet, Gs^Fp, Gs^Fp, Gg, Hh, Gs^Fp, Mm, Uu^Ii, Uu, Uu^Vud, Uu, Uu^Vud, Uh, Xu, Mm, Hh, Mm, Mm, Mm, Mm, Gs^Fp, Mm, Hh, Gs^Fp, Ww, Ww, Gg, Gg, Gs^Fp, Ww, Gs^Fp, Re, Gs^Fp, Gs^Fp, Gs^Fp, Gs^Fp
Wo, Wo, Wo, Wo, Wo, Wo, Ww, Wwf, Wwf, Ww, Gg^Vh, Re^Gvs, Re^Gvs, Rr, Gs^Fp, Gs^Fp, Gg^Fet, Gs^Fp, Gs^Fp, Gs^Fp, Gs^Fp, Gg^Ve, Gs^Fp, Gs^Fp, Gg, Gs^Fp, Gs^Fp, Re, Hh, Uu^Uf, Xu, Xu, Xu, Xu, Mm, Mm, Gg, Hh, Hh, Hh, Hh, Mm, Hh, Hh, Hh, Gg, Gs^Fp, Ww, Gs^Fp, Ww, Re, Ww^Bw/, Hh, Re, Cv, 9 Kv, Gs^Fp
Wo, Wo, Ww^Vm, Wo, Wo, Ww^Vm, Ww, Ww, Wwf, Wwf, Re, Re^Gvs, Rp, Rp, Re^Gvs, Gs^Fp, Gs^Fp, Gg^Ve, Gs^Fp, Gs^Fp, Gg, Hh, Gg, Gg, Gg, Gg, Re, Re, Mm, Xu, Mm, Mm, Mm, Mm, Hh, Hh, Gg, Gg, Gg, Gg, Gg, Gs^Fp, Hh, Hh^Vhh, Gg, Gg, Gg, Ww, Ww, Ww, Re, Ww, Ww, Gg, Gs^Fp, Cv, Gs^Fp
Wo, Wo, Wo, Wwf, Ww, Ww, Ww, Wwf, Ww, Ds, Ds, Rp, Gg, Re^Gvs, Re^Gvs, Gg, Gg, Gs^Fp, Gg, Gg, Re, Re, Re, Re, Re, Re, Gg, Gg, Gg, Mm, Hh, Hh, Gg, Hh, Gg, Gg, Ss, Ds, Ds, Gg, Ss, Hh, Chr, Hh, Hh, Hh, Hh, Gg, Gs^Fp, Gg, Re, Hh, Gg, Ww, Ww, Gs^Fp, Ww
Wo, Wo, Ww, Wo, Ww, Ww, Ww^Bw\, Wwf, Ww, Ww, Ww, Ww^Bw|, Ww, Gg^Vh, Ss, Re, Re, Gg, Re, Re, Gg, Gg, Gg^Vh, Gg, Gg, Re, Re, Gs^Fp, Gs^Fp, Gg, Gg, Gg, Gg, Gg, Ss, Gs^Fp, Ss, Ss^Vhs, Ss, Gs^Fp, Ss, Chs, Gs^Fp, Hh, Hh, Gs^Fp, Hh, Hh, Gg, Re, Re, Gs^Fp, Gg, Gs^Fp, Gg^Ve, Ww, Gs^Fp
Wo, Ww, Ww, Ww, Ww, Ww, Ww, Gg^Ve, Ww^Bw\, Rp, Rp, Ch, Ch, Ww, Ww, Gg, Re, Re, Gg, Gg, Ww, Ww, Ww, Ww, Ww, Gg, Re, Hh, Re, Gg^Ve, Re, Re, Re, Re, Re, Chs, Re, Ds, Gs^Fp, Ss, Ds, Ss, Ss^Vhs, Gg, Gs^Fp, Hh, Hh, Hh, Hh, Hh, Re, Hh, Re, Gs^Fp, Gs^Fp, Gg^Fet, Gs^Fp
Ww, Ww, Wo, Wo, Wo, Ww, Ww^Bw/, Ds, Ww, Gg^Ve, Rp, 6 Ch, Ch, Rp, Ww, Ww, Ww^Bw|, Gg, Gg, Gg, Ww, Gg, Hh, Hh, Ww, Gg, Gg, Re, Gg, Re, Gg, Gg, Gg, Gg, Gg, Re, Gg, Re, Re, Ss, Ss, Gs^Fp, Ds, Ss, Gs^Fp, Gg, Gg, Gg, Gg, Gg, Gg, Re, Hh, Re, Re, Gs^Fp, Gs^Fp
Ww, Ww, Wo, Wo, Wo, Ww, Ww, Ww, Ww, Ww, Ww, Ch, Ww^Bw\, Ww, Gg^Vh, Re^Gvs, Re, Ww, Ww, Ww, Gg, Hh, Hh, Gg, Gg, Ww, Ww, Gg, Wwf, Gg, Ww, Ww, Ww, Ww, Ww, Hh, Ww, Gg, Gg, Re, Re, Gg, Gg, Ds, Gg, Ss, Gg, Gg, Gs^Fp, Hh, Gg, Hh, Gg, Hh, Hh, Re, Re
Ww, Wo, Wo, Wo, Ww, Ww, Ww, Ww, Hh, Ds, Gg^Vh, Ww, Gg, Rp, Rp, Re^Gvs, Re, Gg, Gg, Ww, Gg, Hh, Hh, Hh, Hh, Gg, Gg, Wwf, Gg, Wwf, Gg, Gg, Gg, Gg^Vh, Gg, Ww, Gg, Ww, Ww, Gg, Gg, Re, Re, Gg, Gg, Gg, Gs^Fp, Gg, Gg, Gg, Gg, Gg, Gg, Hh, Hh, Hh, Hh
Ww, Ww, Ww, Ww, Wo, Ww, Ww, Hh, Gg, Re^Gvs, Re^Gvs, Gg, Re, Gg, Re, Rp, Rp, Gg, Gg, Gg, Gg, Gg, Hh, Mm, Mm, Hh, Re^Gvs, Re^Gvs, Gg^Vh, Gg, Gs^Fp, Gs^Fp, Gg, Gg, Gs, Gg, Gs, Gg, Gg, Ww, Hh, Gg, Re, Gg, Gg, Gs^Fp, Hh, Gg, Ww, Gg, Gg, Gs^Fp, Hh, Gg, Gg, Gg, Gg
Ww, Ww, Chw, Ww, Ww, Wo, Wo, Ww, Ww, Re, Re, Re, Gg, Re, Gg, Gg, Rp, Gg, Gs^Fp, Gs^Fp, Gs^Fp, Gs^Fp, Gg, Hh, Hh, Hh, Hh, Re^Gvs, Gg, Gs^Fp, Gs^Fp, Gs^Fp, Gs^Fp, Gs^Fp, Gs, Gs, Gs, Hh, Gg, Ww, Ww, Ww, Ww^Bw|, Ww, Ww, Ww, Ww, Ww, Gg, Ww, Ww, Gg, Gg, Gg, Gg, Gs^Fp, Gg
Ww, Ch, Dd, Ww, Ww, Wo, Wo, Ww, Ww, Hh, Gg, Gg, Re^Gvs, Gg, Rp, Rp, Gs^Fp, Gs^Fp, Gs^Fp, Hh, Gs^Fp, Gs^Fp, Gg, Gg, Hh, Hh, Mm, Hh, Hh, Gg, Gs^Fp, Hh, Gs^Fp, Gs, Gs, Gs, Ww, Ww, Kh, Gg, Ww, Hh, Re, Gg, Gg, Gg, Re^Gvs, Gg, Gg, Gg, Gg, Ww, Ww, Ww, Ww, Gg, Gg
Ww, Dd, Gs^Ft, Ww, Gs^Ft, Ww, Ww, Ww, Ds, Ds, Gg, Re^Gvs, Re^Gvs, Rp, Gs^Fp, Gs^Fp, Gs^Fp, Gs^Fp, Gs^Fp, Gs^Fp, Gs^Fp, Gs^Fp, Gg, Gg, Hh, Mm, Mm, Hh, Hh, Gs^Fp, Gs^Fp, Gs^Fp, Gs^Fp, Gs, Gs, Gs, Gs, Ww, Ch, Hh, Ww, Gg, Re, Gg, Gg, Re^Gvs, Re^Gvs, Gg, Hh, Hh, Hh, Gg, Gg, Gg, Gg, Ww, Ww
Ww, Gs^Vht, Ww, Ww, Ss, Gs, Ww, Ww, Gs^Fp, Gg, Gg, Gg, Gg^Vh, Rp, Rp, Gs^Fp, Gs^Fp, Hh, Gs^Fp, Gg^Fet, Gs^Fp, Gs^Fp, Gg, Gg, Hh, Mm, Hh, Hh, Ch, Ch, Gg, Gs^Fp, Gg, Gg^Vh, Re^Gvs, Gs, Gs, Gs, Gs, Gg, Ww, Gs^Fp, Hh, Re, Re, Gg^Vh, Gg, Gg, Hh, Mm, Hh, Gg, Gg, Gg, Gg, Gg, Gg
Ww, Ww, Gs^Ft, Ww, Ww, Ww, Ww, Gg, Hh, Gs^Fp, Ww, Ww, Ww^Bw/, Gg, Kh, Gs^Fp, Gs^Fp, Gs^Fp, Gg, Gs^Fp, Gg, Gg, Gs^Fp, Gg, Hh, Hh, Hh, Hh, Rp, Gg, Gg^Vh, Gg, Gg, Re^Gvs, Re^Gvs, Gg, Gg^Vh, Gs, Gs, Gg, Hh, Ww, Ww, Hh, Gg, Re, Gg, Gg, Hh, Hh, Mm, Hh, Hh, Gg, Gg, Ss, Dd
Ww, Dd, Dd^Vdt, Ww, Wo, Ww, Ww, Gg, Chs, Ww, Ww, Ww, Ww, Ww, Rp, Ch, Rp, Rp, Rp, Gg, Gg, Gs^Fp, Hh, Hh, Mm, Mm, Hh, Gg, Rp, Gg, Re^Gvs, Re^Gvs, Gg^Wm, 1 Gg, Gg^Vh, Gg, Re^Gvs, Re^Gvs, Gs, Gs, Gg, Gg, Gg, Ww, Gs^Fp, Re, Re^Gvs, Re^Gvs, Hh, Mm, Mm, Mm, Hh, Hh, Gg, Ss, Ss
Wo, Ww, Ww, Ww, Wo, Wo, Ww, Ch, Ww, Ww, Chw, Ww, Gg, Gg^Vh, Rp, Rp, Re^Gvs, Re^Gvs, Gg, Rp, Rp, Gg, Hh, Mm, Mm, Hh, Hh, Gg, Rp, Gg, Gg^Vh, Re^Gvs, Gg, Re^Gvs, Re^Gvs, Gg, Gg, Re^Gvs, Gg, Gg, Hh, Hh, Gg, Ww, Gs^Fp, Re, Gg^Vh, Re^Gvs, Hh, Hh, Mm, Mm, Hh, Hh, Gg, Gg, Ss
Wo, Wo, Ww, Ww, Ww, Ww, Ww, Ww, Ww^Vm, Ww, Ww, Ww, Gg, Rp, Gg, Gg, Gg, Re^Gvs, Gs^Fp, Gg, Gg, Rp, Rp, Hh, Hh, Hh^Vhh, Gg, Gg, Rp, Re^Gvs, Re^Gvs, Gg, Ch, Re^Gvs, Ch, Rp, Ch, Gg, Gg^Ve, Hh, Hh, Hh, Ww, Ww, Gg, Re, Gg, Gg, Gg, Hh, Hh, Hh, Hh, Gg, Gg, Dd, Ss
Wo, Ww, Gs^Fp, Gg, Ww, Gg^Ve, Ww, Ww, Wo, Ww, Ww^Vm, Ds, Rp, Rp, Gg, Gg, Ds, Ss, Ds, Ss, Chs, Gg, Gg, Rp, Rp, Hh, Gg, Ch, Kh, Re^Gvs, Rp, Rp, Rp, Rp, Rp, Ch, Rp, Gg, Gg, Gg, Ww, Ww, Hh, Gg, Re, Re, Gg, Gg, Gg, Hh^Vhh, Hh, Hh, Hh, Hh, Gg, Ss, Ss
Wo, Ww, Ch, Ww, Ww, Gg, Ww, Wo, Wo, Ww, Ds, Ds, Rp, Gg, Gg, Gg, Gs^Fp, Gs^Fp, Ss, Ss, Ss, Chs, Gg, Gg, Rp, Rp, Rp, Ch, Ch, Ch, Gg, Gg, Gg, Ch, Gg, Ch, Gg^Ve, Ch, Gg, Ww, Gs^Fp, Gg, Re, Re, Gs^Fp, Re, Re, Chr, Hh, Hh, Mm, Mm, Hh, Hh, Gg, Ss, Ss
Wo, Ww, Ch, Hh, Gg^Ve, Gs^Fp, Ww, Ww, Ww, Ww, Gg^Vh, Rp, Re^Gvs, Re^Gvs, Re^Gvs, Ss, Ss, Ds, Ds, Ss^Vhs, Ds, Ss, Gs^Fp, Gs^Fp, Rp, Ch, Re^Gvs, Re^Gvs, Gg, Gg, Ww, Ww, Ww, Gg, Ww, Gg, Ww, Gg, Ww, Ww, Gg, Re, Gg, Gg, Gs^Fp, Gs^Fp, Gg, Re, Chr, Chr, Mm, Mm, Hh, Gg, Gg, Dd, Ss
Ww, Ww, Ww, Gg, Ww, Ww, Ww, Ww, Ds, Gg, Rp, Rp, Gg, Re^Gvs, Re, Gg, Gg, Gs^Fp, Ss, Ss, Ss, Ss, Ss, Ds, Rp, Gg, Gg^Vh, Re^Gvs, Hh, Ww, Hh, Hh, Ww, Ww, Hh, Ww, Gg, Ww, Gs^Fp, Gg, Re, Re, Gg, Gs^Fp, Gs^Fp, Gs^Fp, Hh^Vhh, Hh, Chr, 5 Khr, Mm, Hh, Hh, Hh, Gg, Ss, Ss
Ww, Ww, Wo, Ww, Wo, Ww, Ww, Ww^Bw\, Ds, Ch, Gg, Gg^Vh, Re, Re, Gs^Fp, Re, Re, Gg, Gg, Gs^Fp, Ss, Ds, Ss, Ds, Gg, Rp, Hh, Hh, Ww, Ww, Hh, Hh, Ww, Gg, Hh, Hh, Gg, Hh, Re, Re, Gg, Gg, Gs^Fp, Gg, Hh, Hh, Hh, Hh, Mm, Mm, Mm, Mm, Hh, Hh, Hh, Gg, Ss
Ww, Wo, Wo, Wo, Ww, Ww, Gg, Ds, Gg, Ch, Gg, Gg, Re, Gs^Fp, Hh, Gs^Fp, Gs^Fp, Re, Gg, Ds, Ss, Gs^Fp, Ds, Ss, Gg, Rp, Hh, Ww, Hh, Hh, Ww, Ww, Gg, Hh, Mm, Hh, Hh, Gg, Re, Gg, Gg, Gg, Gg, Gg, Hh, Mm, Mm, Mm, Mm, Mm^Xm, Mm, Mm, Hh, Hh, Hh, Gg, Dd
Ww, Ww, Ww, Ww, Ds, Re, Re, Hh, Gg, Gg, Re, Hh, Re, Gs^Fp, Gs^Fp, Gg^Fet, Gs^Fp, Re, Re, Gg, Gg, Gs^Fp, Ss, Ss, Hh, Rp, Rp, Hh, Wwf, Ww, Gg, Hh, Hh, Hh, Gs^Fp, Hh, Hh, Gg, Re, Gg, Re^Gvs, Re^Gvs, Gg, Hh, Hh, Mm, Hh, Hh, Hh, Mm, Hh, Hh, Hh, Hh, Gg, Dd, Dd
Ds, Ds, Ww, Ds, Gg, Gg, Re, Hh, Re, Re, Gs^Fp, Re, Gs^Fp, Gs^Fp, Gg^Fet, Gg^Ve, Gs^Fp, Gs^Fp, Gs^Fp, Re, Re, Gg, Gg, Hh, Hh, Mm, Rp, Hh, Wwf, Wwf, Hh, Hh, Hh, Gs^Fp, Gs^Fp, Gs^Fp, Gg, Gg, Re, Gg, Gg^Vh, Re^Gvs, Hh, Hh, Hh, Hh, Gg, Hh, Gg, Hh, Gg, Hh, Gg, Gg, Gg, Dd, Ss
Gg, Gg, Ww, Gg, Re^Gvs, Re^Gvs, Gg^Wm, Re, Gg, Gs^Fp, Hh, Gs^Fp, Gs^Fp, Hh, Gs^Fp, Gs^Fp, Cv, Gs^Fp, Ww, Gg, Gg, Re, Gg, Hh, Ww, Hh, Ww^Bw|, Wwf, Hh, Hh, Mm, Hh, Hh, Gs^Fp, Gg, Gs^Fp, Re, Re, Gg, Gg, Gg, Gg, Hh, Mm, Hh, Hh, Gg, Gg, Ss, Gg, Ss, Gg, Ss, Dd, Dd, Ss, Ss
Gg, Hh, Ww, Gg, Gg, Re^Gvs, Hh, Gg, Gg, Gs^Fp, Gg^Ve, Gs^Fp, Cv, Gs^Fp, Wwf, Wwf, Wwf, Ww, Gs^Fp, Ww, Ww, Ww^Bw|, Ww, Ww, Hh, Ww, Rp, Hh, Hh, Mm, Hh, Hh, Gg, Gg, Re, Re, Re^Gvs, Re^Gvs, Gg^Vh, Gg, Ch, Hh, Mm, Mm, Hh, Gg, Ss, Ss, Dd, Ss, Ss, Ss, Dd, Ss, Ss, Ss, Dd
Gg, Hh, Hh, Ww, Ww, Hh, Gg, Gg, Gs^Fp, Hh, Gs^Fp, Gg^Fet, Ww, Wwf, 2 Cv, Cv, Gs^Fp, Gs^Fp, Hh, Gs^Fp, Gg, Re, Gg, Gg, Dd, Hh, Ch, Hh, Dd, Hh, Gg, Gg, Gg, Re, Gg, Gg, Gg, Re^Gvs, Gg, Gg, Ch, Hh, Hh, Hh, Gg, Gg, Dd, Ss, Ss, Ss, Dd, Dd, Dd, Ss, Dd, Dd, Dd
Gs, Gs, Gs, Gg, Gg, Ww, Ww, Ww, Ww, Gs^Fp, Ww, Ww, Gg^Ve, Gg^Fet, Cv, Cv, Gs^Fp, Gg^Fet, Gs^Fp, Gs^Fp, Gg, Re, Gg, Dd, Dd, Ch, Dd, Dd, Dd, Hd, Dd, Gg, Rd, Rd, Dd, Gg, Dd, Gg, Dd, Gg, Dd, Dd, Dd, Dd, Dd, Dd, Dd, Ss, Dd, Dd, Dd, Ss, Ss, Hd, Dd^Dc, Dd, Dd
Dd, Dd, Dd, Dd, Dd^Vdt, Gs, Gs, Gs, Gs, Ww, Gs^Fp, Gs^Fp, Gs^Fp, Gs^Fp, Gs^Fp, Gs^Fp, Gs^Fp, Gg^Ve, Gs, Gg, Rd, Rd, Dd, Dd, Dd^Vda, Dd, Hd, Dd^Vda, Dd, Dd, Dd^Dc, Rd, Dd, Dd, Hd, Dd, Dd, Dd^Dc, Hd, Dd, Dd^Do, Dd, Dd, Hd, Ss, Ss, Dd^Dc, Dd, Ss, Dd, Hd, Ss, Dd, Dd, Ss, Dd, Dd
Hd, Hd, Dd, Dd, Dd, Dd, Dd, Dd, Dd, Gs, Gs, Gs, Gs, Gs^Fp, Gs^Fp, Gs^Fp, Gs, Gs, Gs, Rd, Dd, Dd, Dd, Dd, Dd, Dd, Dd, Dd, Dd, Dd, Dd, Rd, Dd, Dd, Dd, Dd, Dd, Dd, Dd, Dd, Dd, Dd, Dd, Dd, Dd, Ss, Dd, Dd, Ss, Ss, Dd, Dd, Ss, Ss, Ss, Dd, Dd